{
	"name": "Intermediate01",
	"width": 8,
	"height": 8,
	"_地格索引": "0=空地 1=墙体 2=冰面 3=目标点",
	"_实体索引": "0=无 1=玩家 2=箱子",
	"tiles": [
		[ 1, 1, 1, 1, 1, 1, 1, 1 ],
		[ 1, 0, 0, 0, 0, 0, 0, 1 ],
		[ 1, 0, 0, 0, 0, 0, 0, 1 ],
		[ 1, 1, 0, 2, 2, 2, 0, 1 ],
		[ 1, 1, 0, 2, 1, 1, 1, 1 ],
		[ 1, 3, 0, 2, 1, 1, 1, 1 ],
		[ 1, 1, 1, 3, 1, 0, 0, 0 ],
		[ 0, 0, 1, 1, 1, 0, 0, 0 ]
	],
	"entities": [
		[ 0, 0, 0, 0, 0, 0, 0, 0 ],
		[ 0, 0, 0, 0, 0, 0, 0, 0 ],
		[ 0, 0, 2, 0, 0, 0, 0, 0 ],
		[ 0, 0, 0, 0, 0, 2, 0, 0 ],
		[ 0, 0, 0, 1, 0, 0, 0, 0 ],
		[ 0, 0, 0, 0, 0, 0, 0, 0 ],
		[ 0, 0, 0, 0, 0, 0, 0, 0 ],
		[ 0, 0, 0, 0, 0, 0, 0, 0 ]
	]
}
